111111111111111
10P110000C000E1
100000011100011
100000111000111
111110111C01111
111111111111111
